2 13 31
###############################
#p * *2       *  ** * *      *#
# # # # #*# # #*# # # # # #*# #
#    * * *** **      *    **  #
# #*# # # # #5# #b#1# # # # #*#
#          *     **      *  **#
# # #*# # # # # #*#*#*#*# # # #
#   *        *   * *x* *      #
# # # # #*# # # # # # #*# #*# #
#   ****         *4           #
# # # # # # # # # #*# # # # #*#
#  ** *   *    3           1  #
###############################